sim = yes
obrigado = thank you
adeus = goodbye
sorrir = smile
hoje = today
aeroporto = airport
oi = hi
prazer = nice to meet you
de nada = you're welcome
tudo bem = how are you
semana = week
ano = year
ontem = yesterday
amanha = tomorrow
poder = can
usar = use
fazer = do
longe = far
pequeno = small
bom = good
bonito = beautiful
feio = ugly
dificil = difficult
mau = bad
perto = near
cerveja = beer
vinho = wine
frango = chicken
peixe = fish
cozinheiro = cook
engenheiro = engineer
gerente = doctor
enfermeira = nurse
professora = teacher
programador = programmer
vendedor = salesman
bom dia = good morning
bom tarde = good afternoon
boa noite = good evening
boa noite = good night
delicioso = delicious